text,intent,location,blurry_time,weather_dot
北京今天的天气怎么样|request_search_blurry_weather|北京，今天，天气
厦门今天的天气怎么样|request_search_blurry_weather|厦门，今天，天气
上海明天的天气怎么样|request_search_blurry_weather|上海，明天，天气
合肥明天的天气怎么样|request_search_blurry_weather|合肥，明天，天气
南京后天的天气怎么样|request_search_blurry_weather|南京，后天，天气
芜湖后天的天气怎么样|request_search_blurry_weather|芜湖，后天，天气
石家庄大后天的天气怎么样|request_search_blurry_weather|石家庄，大后天，天气
深圳大后天的天气怎么样|request_search_blurry_weather|深圳，大后天，天气
广州未来一周的天气怎么样|request_search_blurry_weather|广州，未来一周，天气
南昌未来一周的天气怎么样|request_search_blurry_weather|南昌，未来一周，天气
我想查哈尔滨未来一周的天气|request_search_blurry_weather|哈尔滨，未来一周，天气
我想查乌鲁木齐未来一周的天气|request_search_blurry_weather|乌鲁木齐，未来一周，天气
我想查拉萨未来一周的天气|request_search_blurry_weather|拉萨，未来一周，天气
我想查郑州未来一周的天气|request_search_blurry_weather|郑州，未来一周，天气

text,intent,location,weather_dot
合肥的天气怎么样|utter_ask_time|合肥，天气
北京的天气怎么样|utter_ask_time|北京，天气
查一下南京的天气怎么样|utter_ask_time|南京，天气
问一下上海的天气|utter_ask_time|上海，天气
麻烦问一下北京的天气|utter_ask_time|北京，天气
合肥天气怎么样|utter_ask_time|合肥，天气
北京天气怎么样|utter_ask_time|北京，天气
厦门的天气|utter_ask_time|厦门，天气
武汉的天气|utter_ask_time|武汉，天气

text,intent,blurry_time,weather_dot
今天的天气怎么样|utter_ask_location|今天，天气
请问今天的天气怎么样|utter_ask_location|今天，天气
告诉我今天的天气怎么样|utter_ask_location|今天，天气
麻烦问一下今天的天气怎么样|utter_ask_location|今天，天气
明天的天气怎么样|utter_ask_location|明天，天气
请问今天的天气怎么样|utter_ask_location|明天，天气
告诉我明天的天气怎么样|utter_ask_location|明天，天气
麻烦问一下明天的天气怎么样|utter_ask_location|明天，天气
请问后天的天气怎么样|utter_ask_location|后天，天气
帮我问问明天的天气怎么样|utter_ask_location|明天，天气
帮我查查后天的天气怎么样|utter_ask_location|后天，天气
问一下大后天天气怎么样|utter_ask_location|后天，天气
告诉我后天的天气怎么样|utter_ask_location|后天，天气
麻烦问一下后天天气怎么样|utter_ask_location|后天，天气
帮我查一下后天天气|utter_ask_location|后天，天气
查一下大后天天气|utter_ask_location|大后天，天气
今天的天气怎么样|utter_ask_location|今天，天气
明天的天气怎么样|utter_ask_location|明天，天气
后天的天气怎么样|utter_ask_location|后天，天气
大后天的天气怎么样|utter_ask_location|大后天，天气
未来一周的天气怎么样|utter_ask_location|未来一周，天气


text,intent,location,month,day,weather_dot
哈尔滨九月二十日的天气是什么？|request_search_precise_weather|哈尔滨，九月，二十日，天气
乌鲁木齐九月二十日的天气是什么？|request_search_precise_weather|乌鲁木齐，九月，二十日，天气
齐齐哈尔九月二十日的天气是什么？|request_search_precise_weather|齐齐哈尔，九月，二十日，天气
乌兰察市九月二十日的天气是什么？|request_search_precise_weather|乌兰察市，九月，二十日，天气
厦门九月二十日的天气是什么？|request_search_precise_weather|厦门，九月，二十日，天气
郑州九月十八日的天气是什么？|request_search_precise_weather|郑州，九月，十八日，天气
常州9月29日的天气是什么？|request_search_precise_weather|常州，9月，29日，天气
福州9月22日的天气是什么？|request_search_precise_weather|福州，9月，22日，天气

text,intent,month,day,weather_dot
九月二十日的天气是什么？|utter_ask_location|九月，二十日，天气
九月二十一日的天气是什么？|utter_ask_location|九月，二十一日，天气
9月23日的天气是什么？|utter_ask_location|9月，23日，天气
9月22日的天气是什么？|utter_ask_location|9月，22日，天气

text,intent,special_item,location
北京查一下PM2.5的值|request_search_special_item|PM2.5，北京
厦门现在PM10的值是多少|request_search_special_item|PM10，厦门
厦门查一下AQI|request_search_special_item|AQI，厦门
厦门查一下臭氧值|request_search_special_item|臭氧，厦门
厦门现在空气中O3值是多少|request_search_special_item|O3，厦门
厦门现在空气中的湿度|request_search_special_item|湿度，厦门
厦门查一下一氧化碳|request_search_special_item|一氧化碳，厦门
厦门查一下CO|request_search_special_item|CO，厦门
厦门查一下二氧化硫|request_search_special_item|二氧化硫，厦门
厦门SO2值是多少|request_search_special_item|SO2，厦门
厦门今天最高气温是多少|request_search_special_item|最高气温，厦门
厦门今天最低气温是多少|request_search_special_item|最低气温，厦门
厦门今天的气温|request_search_special_item|气温，厦门
厦门查一下紫外线强度|request_search_special_item|紫外线，厦门
厦门查一下风向|request_search_special_item|风向，厦门
厦门查一下风速|request_search_special_item|风速，厦门


text,intent,special_item
查一下PM2.5的值|utter_ask_location|PM2.5
现在PM10的值是多少|utter_ask_location|PM10
查一下AQI|utter_ask_location|AQI
查一下臭氧值|utter_ask_location|臭氧
现在空气中O3值是多少|utter_ask_location|O3
现在空气中的湿度|utter_ask_location|湿度
查一下一氧化碳|utter_ask_location|一氧化碳
查一下CO|utter_ask_location|CO
查一下二氧化硫|utter_ask_location|二氧化硫
SO2值是多少|utter_ask_location|SO2
今天最高气温是多少|utter_ask_location|最高气温
今天最低气温是多少|utter_ask_location|最低气温
今天的气温|utter_ask_location|气温
查一下紫外线强度|utter_ask_location|紫外线
查一下风向|utter_ask_location|风向
查一下风速|utter_ask_location|风速


text,intent,pollution
查一下空气中污染物的数值|utter_ask_location|污染物
查一下现在的污染情况|utter_ask_location|污染
查一下现在的空气质量|utter_ask_location|空气质量

text,intent,pollution,location
深圳查一下空气中污染物的数值|request_search_pollution|污染物，深圳
深圳查一下现在的污染情况|request_search_pollution|污染，深圳
深圳查一下现在的空气质量|request_search_pollution|空气质量，深圳

text,intent,weather_dot
天气|infrom_weather_dot|天气
气象|infrom_weather_dot|气象

text,intent,pollution
污染物|infrom_pollution|污染物
污染|infrom_pollution|污染
空气质量|infrom_pollution|空气质量

text,intent,blurry_time
未来一周|infrom_blurry_time|未来一周
明天|infrom_blurry_time|明天
后天|infrom_blurry_time|后天
大后天|infrom_blurry_time|大后天
今天|infrom_blurry_time|今天

text,intent,special_item
PM2.5|infrom_special_item|PM2.5
PM10|infrom_special_item|PM10
AQI|infrom_special_item|AQI
S02|infrom_special_item|S02
NO2|infrom_special_item|NO2
O3|infrom_special_item|O3
CO|infrom_special_item|CO
二氧化硫|infrom_special_item|二氧化硫
二氧化氮|infrom_special_item|二氧化氮
臭氧|infrom_special_item|臭氧
一氧化碳|infrom_special_item|一氧化碳
湿度|infrom_special_item|湿度
紫外线|infrom_special_item|紫外线
风向|infrom_special_item|风向
风速|infrom_special_item|风速
最高气温|infrom_special_item|最高气温
最低气温|infrom_special_item|最低气温
气温|infrom_special_item|气温


text,intent,month
一月|infrom_month|一月
二月|infrom_month|二月
三月|infrom_month|三月
四月|infrom_month|四月
五月|infrom_month|五月
六月|infrom_month|六月
七月|infrom_month|七月
八月|infrom_month|八月
九月|infrom_month|九月
十月|infrom_month|十月
十一月|infrom_month|十一月
十二月|infrom_month|十二月
1月|infrom_month|1月
2月|infrom_month|2月
3月|infrom_month|3月
4月|infrom_month|4月
5月|infrom_month|5月
6月|infrom_month|6月
7月|infrom_month|7月
8月|infrom_month|8月
9月|infrom_month|9月
10月|infrom_month|10月
11月|infrom_month|11月
12月|infrom_month|12月


text,intent,day
一日|infrom_day|一日
二日|infrom_day|二日
三日|infrom_day|三日
四日|infrom_day|四日
五日|infrom_day|五日
六日|infrom_day|六日
七日|infrom_day|七日
八日|infrom_day|八日
九日|infrom_day|九日
十日|infrom_day|十日
十一日|infrom_day|十一日
十二日|infrom_day|十二日
十三日|infrom_day|十三日
十四日|infrom_day|十四日
十五日|infrom_day|十五日
十六日|infrom_day|十六日
十七日|infrom_day|十七日
十八日|infrom_day|十八日
十九日|infrom_day|十九日
二十日|infrom_day|二十日
二十一日|infrom_day|二十一日
二十二日|infrom_day|二十二日
二十三日|infrom_day|二十三日
二十四日|infrom_day|二十四日
二十五日|infrom_day|二十五日
二十六日|infrom_day|二十六日
二十七日|infrom_day|二十七日
二十八日|infrom_day|二十八日
二十九日|infrom_day|二十九日
三十日|infrom_day|三十日
三十一日|infrom_day|三十一日
1日|infrom_day|1日
2日|infrom_day|2日
3日|infrom_day|3日
4日|infrom_day|4日
5日|infrom_day|5日
6日|infrom_day|6日
7日|infrom_day|7日
8日|infrom_day|8日
9日|infrom_day|9日
10日|infrom_day|10日
11日|infrom_day|11日
12日|infrom_day|12日
13日|infrom_day|13日
14日|infrom_day|14日
15日|infrom_day|15日
16日|infrom_day|16日
17日|infrom_day|17日
18日|infrom_day|18日
19日|infrom_day|19日
20日|infrom_day|20日
21日|infrom_day|21日
22日|infrom_day|22日
23日|infrom_day|23日
24日|infrom_day|24日
25日|infrom_day|25日
26日|infrom_day|26日
27日|infrom_day|27日
28日|infrom_day|28日
29日|infrom_day|29日
30日|infrom_day|30日
31日|infrom_day|31日



text,intent,location
北京|inform_location|北京
重庆|inform_location|重庆
上海|inform_location|上海
天津|inform_location|天津
长春|inform_location|长春
长沙|inform_location|长沙
常州|inform_location|常州
成都|inform_location|成都
大连|inform_location|大连
东莞|inform_location|东莞
佛山|inform_location|佛山
福州|inform_location|福州
广州|inform_location|广州
贵阳|inform_location|贵阳
哈尔滨|inform_location|哈尔滨
海口|inform_location|海口
邯郸|inform_location|邯郸
杭州|inform_location|杭州
合肥|inform_location|合肥
惠州|inform_location|惠州
焦作|inform_location|焦作
嘉兴|inform_location|嘉兴
吉林|inform_location|吉林
济南|inform_location|济南
昆明|inform_location|昆明
兰州|inform_location|兰州
柳州|inform_location|柳州
洛阳|inform_location|洛阳
南昌|inform_location|南昌
南京|inform_location|南京
南宁|inform_location|南宁
南通|inform_location|南通
宁波|inform_location|宁波
青岛|inform_location|青岛
泉州|inform_location|泉州
沈阳|inform_location|沈阳
深圳|inform_location|深圳
石家庄|inform_location|石家庄
苏州|inform_location|苏州
台州|inform_location|台州
唐山|inform_location|唐山
潍坊|inform_location|潍坊
威海|inform_location|威海
武汉|inform_location|武汉
无锡|inform_location|无锡
厦门|inform_location|厦门
西安|inform_location|西安
许昌|inform_location|许昌
徐州|inform_location|徐州
扬州|inform_location|扬州
烟台|inform_location|烟台
漳州|inform_location|漳州
郑州|inform_location|郑州
中山|inform_location|中山
珠海|inform_location|珠海
阿坝|inform_location|阿坝
阿克苏|inform_location|阿克苏
阿拉善盟|inform_location|阿拉善盟
阿勒泰|inform_location|阿勒泰
阿里|inform_location|阿里
安康|inform_location|安康
安庆|inform_location|安庆
鞍山|inform_location|鞍山
安顺|inform_location|安顺
安阳|inform_location|安阳
白城|inform_location|白城
百色|inform_location|百色
白山|inform_location|白山
白银|inform_location|白银
蚌埠|inform_location|蚌埠
保定|inform_location|保定
宝鸡|inform_location|宝鸡
保山|inform_location|保山
包头|inform_location|包头
巴彦淖尔|inform_location|巴彦淖尔
巴音郭楞|inform_location|巴音郭楞
巴中|inform_location|巴中
北海|inform_location|北海
本溪|inform_location|本溪
毕节|inform_location|毕节
滨州|inform_location|滨州
博尔塔拉|inform_location|博尔塔拉
亳州|inform_location|亳州
沧州|inform_location|沧州
常德|inform_location|常德
昌都|inform_location|昌都
昌吉|inform_location|昌吉
长治|inform_location|长治
巢湖|inform_location|巢湖
朝阳|inform_location|朝阳
潮州|inform_location|潮州
承德|inform_location|承德
郴州|inform_location|郴州
赤峰|inform_location|赤峰
池州|inform_location|池州
崇左|inform_location|崇左
楚雄|inform_location|楚雄
滁州|inform_location|滁州
大理|inform_location|大理
丹东|inform_location|丹东
大庆|inform_location|大庆
大同|inform_location|大同
大兴安岭|inform_location|大兴安岭
达州|inform_location|达州
德宏|inform_location|德宏
德阳|inform_location|德阳
德州|inform_location|德州
定西|inform_location|定西
迪庆|inform_location|迪庆
东营|inform_location|东营
鄂尔多斯|inform_location|鄂尔多斯
恩施|inform_location|恩施
鄂州|inform_location|鄂州
防城港|inform_location|防城港
抚顺|inform_location|抚顺
阜新|inform_location|阜新
阜阳|inform_location|阜阳
抚州|inform_location|抚州
甘南|inform_location|甘南
赣州|inform_location|赣州
甘孜|inform_location|甘孜
广安|inform_location|广安
广元|inform_location|广元
贵港|inform_location|贵港
桂林|inform_location|桂林
果洛|inform_location|果洛
固原|inform_location|固原
海北|inform_location|海北
海东|inform_location|海东
海南|inform_location|海南
海西|inform_location|海西
哈密|inform_location|哈密
汉中|inform_location|汉中
鹤壁|inform_location|鹤壁
河池|inform_location|河池
鹤岗|inform_location|鹤岗
黑河|inform_location|黑河
衡水|inform_location|衡水
衡阳|inform_location|衡阳
和田地|inform_location|和田地
河源|inform_location|河源
菏泽|inform_location|菏泽
贺州|inform_location|贺州
红河|inform_location|红河
淮安|inform_location|淮安
淮北|inform_location|淮北
怀化|inform_location|怀化
淮南|inform_location|淮南
黄冈|inform_location|黄冈
黄南|inform_location|黄南
黄山|inform_location|黄山
黄石|inform_location|黄石
呼和浩特|inform_location|呼和浩特
葫芦岛|inform_location|葫芦岛
呼伦贝尔|inform_location|呼伦贝尔
湖州|inform_location|湖州
佳木斯|inform_location|佳木斯
江门|inform_location|江门
吉安|inform_location|吉安
嘉峪关|inform_location|嘉峪关
揭阳|inform_location|揭阳
金昌|inform_location|金昌
晋城|inform_location|晋城
景德镇|inform_location|景德镇
荆门|inform_location|荆门
荆州|inform_location|荆州
金华|inform_location|金华
济宁|inform_location|济宁
晋中|inform_location|晋中
锦州|inform_location|锦州
九江|inform_location|九江
酒泉|inform_location|酒泉
鸡西|inform_location|鸡西
开封|inform_location|开封
喀什地|inform_location|喀什地
克拉玛依|inform_location|克拉玛依
克孜勒|inform_location|克孜勒
来宾|inform_location|来宾
莱芜|inform_location|莱芜
廊坊|inform_location|廊坊
拉萨|inform_location|拉萨
乐山|inform_location|乐山
凉山|inform_location|凉山
连云港|inform_location|连云港
聊城|inform_location|聊城
辽阳|inform_location|辽阳
辽源|inform_location|辽源
丽江|inform_location|丽江
临沧|inform_location|临沧
临汾|inform_location|临汾
临夏|inform_location|临夏
临沂|inform_location|临沂
林芝|inform_location|林芝
丽水|inform_location|丽水
六安|inform_location|六安
六盘水|inform_location|六盘水
陇南|inform_location|陇南
龙岩|inform_location|龙岩
娄底|inform_location|娄底
漯河|inform_location|漯河
泸州|inform_location|泸州
吕梁|inform_location|吕梁
马鞍山|inform_location|马鞍山
茂名|inform_location|茂名
眉山|inform_location|眉山
梅州|inform_location|梅州
绵阳|inform_location|绵阳
牡丹江|inform_location|牡丹江
南充|inform_location|南充
南平|inform_location|南平
南阳|inform_location|南阳
那曲|inform_location|那曲
内江|inform_location|内江
宁德|inform_location|宁德
怒江|inform_location|怒江
盘锦|inform_location|盘锦
攀枝花|inform_location|攀枝花
平顶山|inform_location|平顶山
平凉|inform_location|平凉
萍乡|inform_location|萍乡
普洱|inform_location|普洱
莆田|inform_location|莆田
濮阳|inform_location|濮阳
黔东|inform_location|黔东
黔南|inform_location|黔南
黔西南|inform_location|黔西南
庆阳|inform_location|庆阳
清远|inform_location|清远
秦皇岛|inform_location|秦皇岛
钦州|inform_location|钦州
齐齐哈尔|inform_location|齐齐哈尔
七台河|inform_location|七台河
曲靖|inform_location|曲靖
衢州|inform_location|衢州
日喀则|inform_location|日喀则
日照|inform_location|日照
三门峡|inform_location|三门峡
三明|inform_location|三明
三亚|inform_location|三亚
商洛|inform_location|商洛
商丘|inform_location|商丘
上饶|inform_location|上饶
山南|inform_location|山南
汕头|inform_location|汕头
汕尾|inform_location|汕尾
韶关|inform_location|韶关
绍兴|inform_location|绍兴
邵阳|inform_location|邵阳
十堰|inform_location|十堰
石嘴山|inform_location|石嘴山
双鸭山|inform_location|双鸭山
朔州|inform_location|朔州
四平|inform_location|四平
松原|inform_location|松原
绥化|inform_location|绥化
遂宁|inform_location|遂宁
随州|inform_location|随州
宿迁|inform_location|宿迁
宿州|inform_location|宿州
塔城地|inform_location|塔城地
泰安|inform_location|泰安
太原|inform_location|太原
泰州|inform_location|泰州
天水|inform_location|天水
铁岭|inform_location|铁岭
铜川|inform_location|铜川
通化|inform_location|通化
通辽|inform_location|通辽
铜陵|inform_location|铜陵
铜仁|inform_location|铜仁
吐鲁番|inform_location|吐鲁番
渭南|inform_location|渭南
文山|inform_location|文山
温州|inform_location|温州
乌海|inform_location|乌海
芜湖|inform_location|芜湖
乌兰察布|inform_location|乌兰察布
乌鲁木齐|inform_location|乌鲁木齐
武威|inform_location|武威
吴忠|inform_location|吴忠
梧州|inform_location|梧州
襄樊|inform_location|襄樊
湘潭|inform_location|湘潭
湘西|inform_location|湘西
咸宁|inform_location|咸宁
咸阳|inform_location|咸阳
孝感|inform_location|孝感
锡林郭勒盟|inform_location|锡林郭勒盟
兴安盟|inform_location|兴安盟
邢台|inform_location|邢台
西宁|inform_location|西宁
新乡|inform_location|新乡
信阳|inform_location|信阳
新余|inform_location|新余
忻州|inform_location|忻州
西双版纳|inform_location|西双版纳
宣城|inform_location|宣城
雅安|inform_location|雅安
延安|inform_location|延安
延边|inform_location|延边
盐城|inform_location|盐城
阳江|inform_location|阳江
阳泉|inform_location|阳泉
宜宾|inform_location|宜宾
宜昌|inform_location|宜昌
伊春|inform_location|伊春
宜春|inform_location|宜春
伊犁哈萨克|inform_location|伊犁哈萨克
银川|inform_location|银川
营口|inform_location|营口
鹰潭|inform_location|鹰潭
益阳|inform_location|益阳
永州|inform_location|永州
岳阳|inform_location|岳阳
玉林|inform_location|玉林
榆林|inform_location|榆林
运城|inform_location|运城
云浮|inform_location|云浮
玉树|inform_location|玉树
玉溪|inform_location|玉溪
枣庄|inform_location|枣庄
张家界|inform_location|张家界
张家口|inform_location|张家口
张掖|inform_location|张掖
湛江|inform_location|湛江
肇庆|inform_location|肇庆
昭通|inform_location|昭通
镇江|inform_location|镇江
中卫|inform_location|中卫
周口|inform_location|周口
舟山|inform_location|舟山
驻马店|inform_location|驻马店
株洲|inform_location|株洲
淄博|inform_location|淄博
自贡|inform_location|自贡
资阳|inform_location|资阳
遵义|inform_location|遵义
阿城|inform_location|阿城
安福|inform_location|安福
安吉|inform_location|安吉
安宁|inform_location|安宁
安丘|inform_location|安丘
安溪|inform_location|安溪
安义|inform_location|安义
安远|inform_location|安远
宝应|inform_location|宝应
巴彦|inform_location|巴彦
滨海|inform_location|滨海
宾县|inform_location|宾县
宾阳|inform_location|宾阳
璧山|inform_location|璧山
博爱|inform_location|博爱
博罗|inform_location|博罗
博兴|inform_location|博兴
苍南|inform_location|苍南
苍山|inform_location|苍山
曹县|inform_location|曹县
长岛|inform_location|长岛
长丰|inform_location|长丰
长海|inform_location|长海
长乐|inform_location|长乐
昌乐|inform_location|昌乐
常山|inform_location|常山
常熟|inform_location|常熟
长泰|inform_location|长泰
长汀|inform_location|长汀
长兴|inform_location|长兴
昌邑|inform_location|昌邑
潮安|inform_location|潮安
呈贡|inform_location|呈贡
城口|inform_location|城口
成武|inform_location|成武
茌平|inform_location|茌平
崇仁|inform_location|崇仁
崇义|inform_location|崇义
崇州|inform_location|崇州
淳安|inform_location|淳安
慈溪|inform_location|慈溪
从化|inform_location|从化
枞阳|inform_location|枞阳
大丰|inform_location|大丰
岱山|inform_location|岱山
砀山|inform_location|砀山
当涂|inform_location|当涂
单县|inform_location|单县
丹阳|inform_location|丹阳
大埔|inform_location|大埔
大田|inform_location|大田
大邑|inform_location|大邑
大余|inform_location|大余
大足|inform_location|大足
德安|inform_location|德安
德化|inform_location|德化
德惠|inform_location|德惠
登封|inform_location|登封
德清|inform_location|德清
德庆|inform_location|德庆
德兴|inform_location|德兴
电白|inform_location|电白
垫江|inform_location|垫江
定南|inform_location|定南
定陶|inform_location|定陶
定远|inform_location|定远
东阿|inform_location|东阿
东海|inform_location|东海
东明|inform_location|东明
东平|inform_location|东平
东山|inform_location|东山
东台|inform_location|东台
洞头|inform_location|洞头
东乡|inform_location|东乡
东阳|inform_location|东阳
东源|inform_location|东源
东至|inform_location|东至
都昌|inform_location|都昌
都江堰|inform_location|都江堰
恩平|inform_location|恩平
法库|inform_location|法库
繁昌|inform_location|繁昌
方正|inform_location|方正
肥城|inform_location|肥城
肥东|inform_location|肥东
肥西|inform_location|肥西
费县|inform_location|费县
丰城|inform_location|丰城
丰都|inform_location|丰都
奉化|inform_location|奉化
奉节|inform_location|奉节
封开|inform_location|封开
丰顺|inform_location|丰顺
凤台|inform_location|凤台
丰县|inform_location|丰县
奉新|inform_location|奉新
凤阳|inform_location|凤阳
分宜|inform_location|分宜
佛冈|inform_location|佛冈
福安|inform_location|福安
福鼎|inform_location|福鼎
浮梁|inform_location|浮梁
富民|inform_location|富民
阜南|inform_location|阜南
阜宁|inform_location|阜宁
福清|inform_location|福清
富阳|inform_location|富阳
赣县|inform_location|赣县
赣榆|inform_location|赣榆
高安|inform_location|高安
藁城|inform_location|藁城
高淳|inform_location|高淳
皋兰|inform_location|皋兰
高陵|inform_location|高陵
高密|inform_location|高密
高青|inform_location|高青
高唐|inform_location|高唐
高要|inform_location|高要
高邑|inform_location|高邑
高邮|inform_location|高邮
高州|inform_location|高州
巩义|inform_location|巩义
广昌|inform_location|广昌
广德|inform_location|广德
广丰|inform_location|广丰
广宁|inform_location|广宁
广饶|inform_location|广饶
光泽|inform_location|光泽
灌南|inform_location|灌南
冠县|inform_location|冠县
灌云|inform_location|灌云
贵溪|inform_location|贵溪
古田|inform_location|古田
固镇|inform_location|固镇
海安|inform_location|海安
海丰|inform_location|海丰
海门|inform_location|海门
海宁|inform_location|海宁
海盐|inform_location|海盐
海阳|inform_location|海阳
含山|inform_location|含山
合川|inform_location|合川
横峰|inform_location|横峰
横县|inform_location|横县
和平|inform_location|和平
鹤山|inform_location|鹤山
和县|inform_location|和县
洪泽|inform_location|洪泽
华安|inform_location|华安
桦甸|inform_location|桦甸
怀集|inform_location|怀集
怀宁|inform_location|怀宁
怀远|inform_location|怀远
桓台|inform_location|桓台
化州|inform_location|化州
惠安|inform_location|惠安
会昌|inform_location|会昌
惠东|inform_location|惠东
惠来|inform_location|惠来
惠民|inform_location|惠民
湖口|inform_location|湖口
呼兰|inform_location|呼兰
霍邱|inform_location|霍邱
霍山|inform_location|霍山
户县|inform_location|户县
建德|inform_location|建德
江都|inform_location|江都
江津|inform_location|江津
将乐|inform_location|将乐
江山|inform_location|江山
姜堰|inform_location|姜堰
江阴|inform_location|江阴
建湖|inform_location|建湖
建宁|inform_location|建宁
建瓯|inform_location|建瓯
建阳|inform_location|建阳
吉安|inform_location|吉安
蛟河|inform_location|蛟河
蕉岭|inform_location|蕉岭
胶南|inform_location|胶南
胶州|inform_location|胶州
嘉善|inform_location|嘉善
嘉祥|inform_location|嘉祥
揭东|inform_location|揭东
界首|inform_location|界首
揭西|inform_location|揭西
即墨|inform_location|即墨
靖安|inform_location|靖安
旌德|inform_location|旌德
井冈山|inform_location|井冈山
靖江|inform_location|靖江
景宁|inform_location|景宁
泾县|inform_location|泾县
井陉|inform_location|井陉
金湖|inform_location|金湖
晋江|inform_location|晋江
金门|inform_location|金门
晋宁|inform_location|晋宁
金坛|inform_location|金坛
金堂|inform_location|金堂
进贤|inform_location|进贤
金溪|inform_location|金溪
金乡|inform_location|金乡
缙云|inform_location|缙云
金寨|inform_location|金寨
晋州|inform_location|晋州
吉水|inform_location|吉水
九江|inform_location|九江
九台|inform_location|九台
绩溪|inform_location|绩溪
济阳|inform_location|济阳
济源|inform_location|济源
鄄城|inform_location|鄄城
莒南|inform_location|莒南
句容|inform_location|句容
莒县|inform_location|莒县
巨野|inform_location|巨野
开化|inform_location|开化
开平|inform_location|开平
开县|inform_location|开县
开阳|inform_location|开阳
康平|inform_location|康平
垦利|inform_location|垦利
昆山|inform_location|昆山
来安|inform_location|来安
莱西|inform_location|莱西
莱阳|inform_location|莱阳
莱州|inform_location|莱州
郎溪|inform_location|郎溪
蓝田|inform_location|蓝田
兰溪|inform_location|兰溪
乐安|inform_location|乐安
乐昌|inform_location|乐昌
雷州|inform_location|雷州
乐陵|inform_location|乐陵
乐平|inform_location|乐平
乐清|inform_location|乐清
乐亭|inform_location|乐亭
连城|inform_location|连城
梁平|inform_location|梁平
梁山|inform_location|梁山
莲花|inform_location|莲花
连江|inform_location|连江
廉江|inform_location|廉江
连南|inform_location|连南
连平|inform_location|连平
连山|inform_location|连山
涟水|inform_location|涟水
连州|inform_location|连州
辽中|inform_location|辽中
黎川|inform_location|黎川
利津|inform_location|利津
临安|inform_location|临安
灵璧|inform_location|灵璧
灵寿|inform_location|灵寿
陵县|inform_location|陵县
临海|inform_location|临海
临清|inform_location|临清
临泉|inform_location|临泉
临朐|inform_location|临朐
临沭|inform_location|临沭
临邑|inform_location|临邑
溧水|inform_location|溧水
柳城|inform_location|柳城
柳江|inform_location|柳江
浏阳|inform_location|浏阳
利辛|inform_location|利辛
溧阳|inform_location|溧阳
隆安|inform_location|隆安
龙川|inform_location|龙川
龙海|inform_location|龙海
龙口|inform_location|龙口
龙门|inform_location|龙门
龙南|inform_location|龙南
龙泉|inform_location|龙泉
龙游|inform_location|龙游
栾城|inform_location|栾城
栾川|inform_location|栾川
滦南|inform_location|滦南
滦县|inform_location|滦县
陆丰|inform_location|陆丰
陆河|inform_location|陆河
庐江|inform_location|庐江
罗定|inform_location|罗定
洛宁|inform_location|洛宁
罗源|inform_location|罗源
鹿泉|inform_location|鹿泉
禄劝|inform_location|禄劝
芦溪|inform_location|芦溪
鹿寨|inform_location|鹿寨
马山|inform_location|马山
梅县|inform_location|梅县
蒙城|inform_location|蒙城
孟津|inform_location|孟津
蒙阴|inform_location|蒙阴
孟州|inform_location|孟州
明光|inform_location|明光
明溪|inform_location|明溪
闽侯|inform_location|闽侯
闽清|inform_location|闽清
木兰|inform_location|木兰
南安|inform_location|南安
南澳|inform_location|南澳
南城|inform_location|南城
南川|inform_location|南川
南丰|inform_location|南丰
南靖|inform_location|南靖
南康|inform_location|南康
南陵|inform_location|南陵
南雄|inform_location|南雄
宁都|inform_location|宁都
宁国|inform_location|宁国
宁海|inform_location|宁海
宁化|inform_location|宁化
宁津|inform_location|宁津
宁乡|inform_location|宁乡
宁阳|inform_location|宁阳
农安|inform_location|农安
磐安|inform_location|磐安
磐石|inform_location|磐石
沛县|inform_location|沛县
蓬莱|inform_location|蓬莱
彭水|inform_location|彭水
彭泽|inform_location|彭泽
彭州|inform_location|彭州
平度|inform_location|平度
平和|inform_location|平和
平湖|inform_location|平湖
屏南|inform_location|屏南
平山|inform_location|平山
平潭|inform_location|平潭
平阳|inform_location|平阳
平阴|inform_location|平阴
平邑|inform_location|平邑
平原|inform_location|平原
平远|inform_location|平远
郫县|inform_location|郫县
邳州|inform_location|邳州
鄱阳|inform_location|鄱阳
浦城|inform_location|浦城
浦江|inform_location|浦江
蒲江|inform_location|蒲江
普兰店|inform_location|普兰店
普宁|inform_location|普宁
迁安|inform_location|迁安
潜山|inform_location|潜山
铅山|inform_location|铅山
迁西|inform_location|迁西
启东|inform_location|启东
齐河|inform_location|齐河
綦江|inform_location|綦江
祁门|inform_location|祁门
清流|inform_location|清流
青田|inform_location|青田
清新|inform_location|清新
青阳|inform_location|青阳
庆元|inform_location|庆元
庆云|inform_location|庆云
清镇|inform_location|清镇
青州|inform_location|青州
沁阳|inform_location|沁阳
邛崃|inform_location|邛崃
栖霞|inform_location|栖霞
全椒|inform_location|全椒
全南|inform_location|全南
曲阜|inform_location|曲阜
曲江|inform_location|曲江
饶平|inform_location|饶平
仁化|inform_location|仁化
融安|inform_location|融安
荣昌|inform_location|荣昌
荣成|inform_location|荣成
融水|inform_location|融水
如东|inform_location|如东
如皋|inform_location|如皋
瑞安|inform_location|瑞安
瑞昌|inform_location|瑞昌
瑞金|inform_location|瑞金
乳山|inform_location|乳山
汝阳|inform_location|汝阳
乳源|inform_location|乳源
三江|inform_location|三江
三门|inform_location|三门
诏安|inform_location|诏安
上高|inform_location|上高
上杭|inform_location|上杭
商河|inform_location|商河
上栗|inform_location|上栗
上林|inform_location|上林
上饶|inform_location|上饶
上犹|inform_location|上犹
上虞|inform_location|上虞
尚志|inform_location|尚志
邵武|inform_location|邵武
绍兴|inform_location|绍兴
沙县|inform_location|沙县
嵊泗|inform_location|嵊泗
嵊州|inform_location|嵊州
莘县|inform_location|莘县
深泽|inform_location|深泽
歙县|inform_location|歙县
射阳|inform_location|射阳
石城|inform_location|石城
石林|inform_location|石林
石狮|inform_location|石狮
石台|inform_location|石台
始兴|inform_location|始兴
石柱|inform_location|石柱
寿光|inform_location|寿光
寿宁|inform_location|寿宁
寿县|inform_location|寿县
双城|inform_location|双城
双流|inform_location|双流
舒城|inform_location|舒城
舒兰|inform_location|舒兰
顺昌|inform_location|顺昌
沭阳|inform_location|沭阳
泗洪|inform_location|泗洪
四会|inform_location|四会
泗水|inform_location|泗水
泗县|inform_location|泗县
泗阳|inform_location|泗阳
嵩明|inform_location|嵩明
松溪|inform_location|松溪
嵩县|inform_location|嵩县
松阳|inform_location|松阳
遂昌|inform_location|遂昌
遂川|inform_location|遂川
睢宁|inform_location|睢宁
濉溪|inform_location|濉溪
遂溪|inform_location|遂溪
宿松|inform_location|宿松
宿豫|inform_location|宿豫
太仓|inform_location|太仓
太和|inform_location|太和
泰和|inform_location|泰和
太湖|inform_location|太湖
泰宁|inform_location|泰宁
台山|inform_location|台山
泰顺|inform_location|泰顺
泰兴|inform_location|泰兴
郯城|inform_location|郯城
唐海|inform_location|唐海
滕州|inform_location|滕州
天长|inform_location|天长
天台|inform_location|天台
桐城|inform_location|桐城
铜鼓|inform_location|铜鼓
通河|inform_location|通河
铜梁|inform_location|铜梁
铜陵|inform_location|铜陵
桐庐|inform_location|桐庐
潼南|inform_location|潼南
铜山|inform_location|铜山
桐乡|inform_location|桐乡
通州|inform_location|通州
瓦房店|inform_location|瓦房店
万安|inform_location|万安
望城|inform_location|望城
望江|inform_location|望江
万年|inform_location|万年
万载|inform_location|万载
微山|inform_location|微山
文成|inform_location|文成
文登|inform_location|文登
翁源|inform_location|翁源
温岭|inform_location|温岭
汶上|inform_location|汶上
温县|inform_location|温县
涡阳|inform_location|涡阳
五常|inform_location|五常
武城|inform_location|武城
吴川|inform_location|吴川
无棣|inform_location|无棣
五河|inform_location|五河
芜湖|inform_location|芜湖
五华|inform_location|五华
无极|inform_location|无极
吴江|inform_location|吴江
五莲|inform_location|五莲
武隆|inform_location|武隆
武鸣|inform_location|武鸣
武宁|inform_location|武宁
武平|inform_location|武平
巫山|inform_location|巫山
无为|inform_location|无为
巫溪|inform_location|巫溪
武义|inform_location|武义
武夷山|inform_location|武夷山
婺源|inform_location|婺源
武陟|inform_location|武陟
峡江|inform_location|峡江
夏津|inform_location|夏津
象山|inform_location|象山
响水|inform_location|响水
仙居|inform_location|仙居
仙游|inform_location|仙游
萧县|inform_location|萧县
霞浦|inform_location|霞浦
息烽|inform_location|息烽
新安|inform_location|新安
新昌|inform_location|新昌
信丰|inform_location|信丰
新丰|inform_location|新丰
新干|inform_location|新干
兴国|inform_location|兴国
兴化|inform_location|兴化
兴宁|inform_location|兴宁
行唐|inform_location|行唐
荥阳|inform_location|荥阳
星子|inform_location|星子
辛集|inform_location|辛集
新建|inform_location|新建
新津|inform_location|新津
新乐|inform_location|新乐
新民|inform_location|新民
新密|inform_location|新密
新泰|inform_location|新泰
新兴|inform_location|新兴
新沂|inform_location|新沂
信宜|inform_location|信宜
新郑|inform_location|新郑
休宁|inform_location|休宁
秀山|inform_location|秀山
修水|inform_location|修水
修文|inform_location|修文
修武|inform_location|修武
寻甸|inform_location|寻甸
寻乌|inform_location|寻乌
徐闻|inform_location|徐闻
盱眙|inform_location|盱眙
阳春|inform_location|阳春
阳东|inform_location|阳东
阳谷|inform_location|阳谷
阳山|inform_location|阳山
阳信|inform_location|阳信
阳西|inform_location|阳西
扬中|inform_location|扬中
偃师|inform_location|偃师
延寿|inform_location|延寿
兖州|inform_location|兖州
伊川|inform_location|伊川
宜丰|inform_location|宜丰
宜黄|inform_location|宜黄
依兰|inform_location|依兰
宜良|inform_location|宜良
沂南|inform_location|沂南
英德|inform_location|英德
颍上|inform_location|颍上
沂水|inform_location|沂水
义乌|inform_location|义乌
黟县|inform_location|黟县
宜兴|inform_location|宜兴
弋阳|inform_location|弋阳
宜阳|inform_location|宜阳
沂源|inform_location|沂源
仪征|inform_location|仪征
永安|inform_location|永安
永川|inform_location|永川
永春|inform_location|永春
永登|inform_location|永登
永定|inform_location|永定
永丰|inform_location|永丰
永吉|inform_location|永吉
永嘉|inform_location|永嘉
永康|inform_location|永康
邕宁|inform_location|邕宁
永泰|inform_location|永泰
永新|inform_location|永新
永修|inform_location|永修
尤溪|inform_location|尤溪
酉阳|inform_location|酉阳
元氏|inform_location|元氏
禹城|inform_location|禹城
于都|inform_location|于都
岳西|inform_location|岳西
余干|inform_location|余干
玉环|inform_location|玉环
余江|inform_location|余江
郁南|inform_location|郁南
云安|inform_location|云安
郓城|inform_location|郓城
云和|inform_location|云和
云霄|inform_location|云霄
云阳|inform_location|云阳
玉山|inform_location|玉山
榆树|inform_location|榆树
鱼台|inform_location|鱼台
玉田|inform_location|玉田
余姚|inform_location|余姚
榆中|inform_location|榆中
赞皇|inform_location|赞皇
增城|inform_location|增城
张家港|inform_location|张家港
漳平|inform_location|漳平
漳浦|inform_location|漳浦
章丘|inform_location|章丘
樟树|inform_location|樟树
沾化|inform_location|沾化
赵县|inform_location|赵县
招远|inform_location|招远
正定|inform_location|正定
政和|inform_location|政和
柘荣|inform_location|柘荣
中牟|inform_location|中牟
忠县|inform_location|忠县
周宁|inform_location|周宁
周至|inform_location|周至
庄河|inform_location|庄河
诸城|inform_location|诸城
诸暨|inform_location|诸暨
紫金|inform_location|紫金
资溪|inform_location|资溪
邹城|inform_location|邹城
邹平|inform_location|邹平
遵化|inform_location|遵化


text,intent
hi|greet
hello|greet
你好|greet
您好|greet
您好吗|greet
嗨|greet
喂|greet
你是谁|greet
您是|greet
你是哪个|greet
啊|greet
请问|greet
问你几个问题|greet
再见|goodbye
拜拜|goodbye
很高兴和你说话|goodbye
撒有拉拉|goodbye
好的|confirm
行|confirm
可以的|confirm
行的|confirm
没问题|confirm
恩|confirm
嗯|confirm
不是这个|deny
不要|deny
不需要|deny
暂时不要了|deny
不是|deny
有问题|deny
我再考虑考虑|deny
不好啦|deny
不行|deny
不可以的|deny
不对|deny
不可以|deny
没了|deny
没有了|deny
不用了|deny
暂时不用了|deny
好的没了|deny
好不用了|deny
thanks|thanks
谢谢|thanks
谢谢您|thanks
谢谢你|thanks
非常感谢|thanks
谢谢啊|thanks
谢了|thanks
